








1111	11111
1001	10001
1001	10001
1001	10001
1001	10001
1001	10001
1001	10001
1001	1101111111
1001	1100000011
1001	1111111111
1001	   1
1001	1111111
1001	1100001
111 	1111111


11111111
10000001
11111111