
SO ./textures/back.xpm
EA ./textures/side.xpm
NO ./textures/front.xpm
WE ./textures/side.xpm


C 130,200,228
F 56,94,0



111111111111111111111111111111111111111111111111
100000000000000000000000000000000000000000000001
100000000000000000000000000000000000000000000001
1000011111100000111111000001111110000010000000001
100001000010000010000010000010000010000010000001
1000011111100000111111000001111110000010000000001
100000000000000000000000000000000000000000000001
100000000000000000000000000000000000000000000001
100001000010000010000010000010000010000010000001
100001000010000010000010000010000010000010000001
100001000010000010000010000010000010000010000001
100000000000000000000000000000000000000000000001
100000000000000000000000000000000000000000000001
100001000010000010000010000010000010000010000001
100001000010000010000010000010000010000010000001
1000000000000000000000000N0000000000000000000001
100000000000000000000000000000000000000000000001
111111111111111111111111111111111111111111111111

