NO ./textures/colorstone.xpm
SO ./textures/bluestone.xpm
WE ./textures/purplestone.xpm
EA ./textures/redbrick.xpm

C 200,230,255
F 80,60,30

1111111111111
1000000000001
10000W0000001
1000000000001
1111111111111
