
SO                      ./textures/t2.xpm
EA ./textures/t4.xpm
NO ./textures/t1.xpm
WE             ./textures/t3.xpm



F 0,250,30


C     255,   225,   100


     111 1111111  111111111111                           1111111
     1001000000111000000000001111                        1000001
      111011000001110000000000001                        1000001
     100100000000000000000000111                          111111 
111111111011000001110000000001
10000000011000001110111111111111
11110111111111011100000010001
11110111111111011101010010001
 1000000110101011100010010001
 10000000000000001100000010001
10000000000000011010100100111
1100001110101011111011111N1111
11110111 111011 10111010101
1111111 111111 111111111111

